0,0,0,0,0,0,0,0,0,0,0,0,0,0,0,0,0,0,0,0,0,0,0,0,0,0,0,0,0,0,0,0,0,0,0,0,0,0,0,0,0,0,0,0,0,0,0,0,0,0
0,0,0,0,0,0,0,0,0,0,0,0,0,0,0,0,0,0,0,0,0,0,0,0,0,0,0,0,0,0,0,0,0,0,0,0,0,0,0,0,0,0,0,0,0,0,0,0,0,0
0,0,301,299,299,299,299,299,299,299,299,299,299,299,299,299,299,299,299,299,299,299,299,299,299,299,299,299,299,299,299,299,299,299,299,299,299,299,299,299,299,300,0,0,0,0,0,0,0,0
0,0,334,290,290,291,290,290,290,290,292,290,290,290,290,290,290,290,290,290,290,290,290,290,290,290,290,290,290,290,290,290,290,290,290,290,290,290,290,332,290,317,0,0,0,0,0,0,0,0
0,0,298,286,286,0,0,0,0,0,0,0,0,0,0,0,0,0,0,0,0,0,0,0,0,0,0,0,0,0,0,0,190,0,0,0,0,0,0,0,0,298,0,0,0,0,0,0,0,0
0,0,355,353,353,354,0,0,0,0,0,0,0,0,301,299,299,0,0,299,299,322,299,299,0,0,299,299,300,0,0,0,191,0,0,0,0,0,0,0,0,298,0,0,0,0,0,0,0,0
0,0,298,0,0,354,0,0,0,351,352,0,0,0,334,290,290,0,0,290,290,333,290,290,0,0,290,290,317,0,0,0,246,247,0,0,0,0,0,0,0,298,0,0,0,0,0,0,0,0
0,0,298,0,0,354,0,0,0,368,369,0,0,0,298,307,308,0,0,0,309,298,0,0,0,0,0,309,298,0,0,0,263,264,0,0,0,0,0,0,0,298,0,0,0,0,0,0,0,0
0,0,356,372,370,371,0,0,0,0,0,0,0,0,298,324,325,0,0,0,326,298,0,0,0,0,0,326,298,0,0,0,265,0,0,0,0,0,0,0,0,298,0,0,0,0,0,0,0,0
0,0,298,0,0,248,0,0,0,0,0,0,0,0,298,276,0,0,0,0,279,298,276,0,0,0,0,279,298,0,0,0,0,0,0,0,0,0,0,0,0,298,0,0,0,0,0,0,0,0
0,0,303,299,299,299,299,300,0,0,0,301,299,299,339,299,299,299,299,299,299,339,299,299,299,299,299,299,339,299,299,299,299,299,299,299,299,299,299,299,299,302,0,0,0,0,0,0,0,0
0,0,290,290,290,290,290,317,0,0,0,334,290,290,290,290,290,290,290,290,290,290,290,290,290,290,290,290,290,290,290,290,290,290,290,290,290,290,290,290,290,290,0,0,0,0,0,0,0,0
0,0,0,0,0,0,0,298,0,0,0,298,0,0,0,0,0,0,0,0,0,0,0,0,0,0,0,0,0,0,0,0,0,0,0,0,0,0,0,0,0,0,0,0,0,0,0,0,0,0
0,0,0,0,0,0,0,298,0,0,0,298,0,0,0,0,0,0,0,0,0,0,0,0,0,343,343,0,0,0,0,0,0,0,0,0,0,0,0,0,0,0,0,0,0,0,0,0,0,0
0,0,0,0,0,0,0,298,0,0,0,298,0,0,0,0,0,0,0,0,0,0,0,0,0,0,0,0,0,0,0,0,0,0,0,0,0,0,0,0,0,0,0,0,0,0,0,0,0,0
0,0,0,0,0,0,0,298,0,0,0,298,0,0,0,0,0,0,0,0,0,0,0,0,0,0,0,0,0,0,0,0,0,0,0,0,0,0,0,0,0,0,0,0,0,0,0,0,0,0
0,0,0,0,0,0,0,298,0,0,0,298,0,0,0,0,0,0,0,0,0,0,0,0,0,0,0,0,0,0,0,0,0,0,0,0,0,0,0,0,0,0,0,0,0,0,0,0,0,0
0,0,0,0,0,0,0,298,0,0,0,298,0,0,0,0,0,0,0,0,0,0,0,0,0,0,0,0,0,0,0,0,0,0,0,0,0,0,0,0,0,0,0,0,0,0,0,0,0,0
0,0,0,0,0,0,0,298,0,0,0,298,0,0,0,0,0,0,0,0,0,0,0,0,0,0,0,0,0,0,0,0,0,0,0,0,0,0,0,0,0,0,0,0,0,0,0,0,0,0
0,0,0,0,0,0,0,298,0,0,0,298,0,0,0,0,0,0,0,0,0,0,0,0,0,0,0,0,0,0,0,0,0,0,0,0,0,0,0,0,0,0,0,0,0,0,0,0,0,0
0,0,0,0,0,0,0,298,0,0,0,298,0,0,0,0,0,0,0,0,0,0,0,0,0,0,0,0,0,0,0,0,0,0,0,0,0,0,0,0,0,0,0,0,0,0,0,0,0,0
0,0,0,0,0,0,0,298,0,0,0,298,0,0,0,0,0,0,0,0,0,0,0,0,0,0,0,0,0,0,0,0,0,0,0,0,0,0,0,0,0,0,0,0,0,0,0,0,0,0
0,0,0,0,0,0,0,298,0,0,0,298,0,0,0,0,0,0,0,0,0,0,0,0,0,0,0,0,0,0,0,0,0,0,0,0,0,0,0,0,0,0,0,0,0,0,0,0,0,0
0,0,0,0,0,0,0,298,0,0,0,298,0,0,0,0,0,0,0,0,0,0,0,0,0,0,0,0,0,0,0,0,0,0,0,0,0,0,0,0,0,0,0,0,0,0,0,0,0,0
0,0,0,0,0,0,0,298,0,0,0,298,0,0,0,0,0,0,0,0,0,0,0,0,0,0,0,0,0,0,0,0,0,0,0,0,0,0,0,0,0,0,0,0,0,0,0,0,0,0
